XXXXXXXXXXXXXXXXXXXXXXXXXXX
XMQQXXXXQQQQQQQQQQQXXXXQQQX
XQXQQQTQQXXXXXXXXXQQTQOQXQX
XOXXXXXQXXXQQQQQXXXXXQXXXQX
XQQQGQQQQQTQXQXQTQQQQQGQQQX
XXXXXXXTXXXQXXXQXQXXXXXXXXX
XQQGQQQQQQTQXQXQTQQQQQQGQQX
XQXXXXXQXQXQQQQQXQXQXXXXXQX
XQOQQQXQXQXXXXXXXQXQQQQQOQX
XXQXXQXQQQQQQQQQQQXQXQXXQXX
XXXXXXXXXXXXXXXXXXXXXXXXXXX
                                 
                                